===============
=F           F=
= = === === = =
= =B=== ===B= =
= = === === = =
=    B P B    =
= = === === = =
= =B=== ===B= =
= = === === = =
=F           F=
===============
